10.ox
..........
oo..oo....
......oo..
.b.......o
oo.....oo.
..........
..o....o..
...o..oo..
..........
..........
