20.ox
..o..o............o.
o.....o....o.......o
.............o...o.o
.o..oo.....o.....o..
o..........o.......o
.o..o......o...o..oo
o......o.....o.o..o.
.o...o...o.o.....oo.
.....o.....o........
.........o...o......
.o..o..ooo..oo....oo
oo...o...o.o..o....o
o...o........oo.....
.......o.....o.....o
.o.oooooo..o..o.....
...ooo...ooo......o.
o..o.....o..oo..o..o
....o...o.o.oo..o...
.o..o..o.o...o......
....o.o....o....o..o
